         ▓▓▓▓▓▓▓▓▓▓▓               
        ▓░░░░░░░░░░░▓              
     ▓▓▓▓░▓▓▓▓▓▓▓▓▓░▓              
    ▓░░░▓░░░▓░░░░░▓░▓              
    ▓░▓░▓▓▓░▓░▓▓▓░▓░▓▓             
    ▓░▓░░░░░▓░▓  ░░░▓o▓            
    ▓░▓▓▓▓▓▓▓░▓ ▓▓▓▓▓░▓            
    ▓░░░▓   ▓░▓ ▓░░░░░▓            
     ▓▓░▓▓▓ ▓░▓▓▓░▓▓▓▓   ▓▓▓       
      ▓░░░░░▓░░░░░▓     ▓░░░▓      
       ▓▓▓▓░▓▓▓▓▓▓▓▓▓▓  ▓░▓░▓      
          ▓░░░░░░░░░░░▓ ▓░▓░▓      
       ▓▓▓▓▓▓▓▓▓▓▓▓▓▓░▓▓▓░▓░▓▓▓▓   
      ▓░░░░░░░░░░░░░▓░▓░░░▓░░░░░▓  
   ▓▓▓▓░▓▓▓▓▓▓▓▓▓▓▓░▓░▓░▓▓▓▓▓▓▓░▓▓ 
  ▓░░░░░▓░░░      ▓░▓░░░▓░░░  ▓░░░▓
  ▓░▓▓▓▓▓░▓░▓    ▓▓░▓▓▓▓▓░▓░▓▓▓▓▓░▓
  ▓░▓★░░░░▓░▓   ▓░░░▓   ▓░▓░░░░░░░▓
  ▓░▓▓▓▓▓▓▓░▓▓▓▓▓░▓ ▓▓▓ ▓░▓▓▓▓▓▓▓▓ 
  ▓░░░░░░░░░▓░░░░░▓     ▓░░░▓      
            ▓░▓▓▓▓▓ ▓▓▓▓▓▓▓░▓      
            ▓░▓     ▓░░░░░▓░▓      
            ▓░▓▓▓▓▓▓▓░▓▓▓░▓░▓      
            ▓░░░░░░░░░  ▓░░░▓      
             ▓▓▓▓▓▓▓▓▓▓▓ ▓▓▓       
