 ▓▓▓▓▓ ▓▓▓▓▓▓▓▓▓ ▓▓▓▓▓ ▓▓▓▓▓ ▓▓▓ ▓▓▓▓▓▓▓
▓░░░░░▓░░░░░░░░░▓░░░░░▓░░░░░▓░░░▓░░░░░░░▓
 ▓▓░▓░▓▓▓░▓▓▓░▓░▓░▓▓▓░▓▓▓░▓░▓░▓░▓▓▓▓▓░▓░▓
▓░░░▓░░░▓░▓░░░▓░░░▓░▓░░░▓░▓░░░▓░░░░░▓░▓░▓
▓░▓▓ ▓▓░▓░▓░▓▓▓▓▓▓▓░▓▓▓░▓░▓▓▓▓▓▓▓▓▓░▓░▓░▓
▓░░░▓░▓░▓░▓░▓░░░▓░░░░░▓░░░▓░░░░░░░▓░▓░▓░▓
 ▓▓░▓░▓░▓▓▓░▓░▓░▓▓▓▓▓░▓▓▓▓▓░▓▓▓▓▓▓▓░▓░▓░▓
▓░░░▓░░░▓░░░▓░▓░░░░░▓░░░░░▓░░░░░░░░░▓░▓░▓
▓░▓▓▓░▓▓▓░▓▓▓░▓▓▓▓▓░▓░▓░▓▓▓░▓▓▓▓▓▓▓▓▓▓▓░▓
▓░▓░░░▓░░░▓░░░░░▓░░░░░▓░▓░░░▓░░░░░░░░░▓░▓
▓░▓░▓▓▓░▓░▓░▓▓▓░▓░▓▓▓▓▓▓▓░▓▓▓▓▓▓▓▓▓░▓░▓░▓
▓░▓░░░▓░▓░▓░░░▓░▓░▓░░░░░▓░░░░░▓░░░░░▓░░░▓
▓░▓▓▓░▓▓▓░▓▓▓▓▓░▓░▓░▓▓▓░▓▓▓▓▓░▓░▓▓▓▓ ▓▓░▓
▓░░░▓░░░░░▓░░░░░▓░▓░▓░░░░░░░▓░░░▓░░░▓░░░▓
▓░▓░▓▓▓▓▓▓▓░▓▓▓▓▓▓▓░▓░▓▓▓▓▓▓▓▓▓▓▓░▓░▓░▓▓
▓░▓░░░▓░░░░░░░░░░░░░▓░▓░░░░░░░░░▓░▓░░░▓░▓
▓⌾▓▓▓░▓░▓▓▓▓▓▓▓▓▓▓▓▓▓░▓░▓▓▓▓▓▓▓░▓░▓▓▓▓▓░▓
▓░▓░░░▓░▓░░░░░░░░░░░▓░▓░▓░░░▓░░░▓░░░▓░░░▓
 ▓▓░▓▓▓▓▓░▓▓▓▓▓▓▓▓▓░▓░▓░▓░▓░▓░▓▓▓▓▓░▓░▓░▓
▓░░░▓░░░▓░░░▓░░░░░▓░▓░░░░░▓░▓░░░░░▓░▓░▓░▓
▓░▓▓▓░▓░▓▓▓░▓░▓▓▓░▓░▓▓▓▓▓▓▓░▓▓▓▓▓░▓░▓░▓▓
▓░░░▓░▓░░░░░▓░▓░░░░░▓o▓░░░▓░▓░░░▓░░░▓░░░▓
▓░▓░▓░▓▓▓▓▓▓▓░▓░▓▓▓▓▓░▓░▓▓▓░▓▓▓░▓▓▓▓▓░▓░▓
▓░▓░▓░░░▓░░░▓░▓░▓░░░░░▓░░░░░░░▓░░░▓░░░▓░▓
▓░▓░▓▓▓░▓▓▓░▓░▓▓▓░▓▓▓▓▓░▓▓▓▓▓░▓░▓░▓▓▓▓▓░▓
▓░▓░░░▓░░░░░▓░░░░░▓░░░░░▓░░░▓░▓░▓░░░▓░░░▓
▓░▓░▓░▓▓▓▓▓░▓▓▓▓▓▓▓▓▓▓▓░▓░▓░▓░▓░▓▓▓░▓░▓░▓
▓░▓░▓░░░░░▓░░░░░░░░░░░▓░▓░▓░▓░░░▓░▓░░░▓░▓
 ▓▓░▓░▓▓▓▓▓▓▓▓▓▓▓▓▓▓▓░▓▓▓░▓░▓▓▓▓▓░▓▓▓▓▓░▓
▓░░░▓░▓░░░░░░░░░░░░░▓░▓░░░▓░░░░░▓░░░░░░░▓
▓░▓▓▓▓▓░▓▓▓▓▓▓▓▓▓▓▓░▓░▓░▓▓▓▓▓▓▓░▓▓▓░▓▓▓▓
▓░▓░░░░░▓░░░░░░░░░▓░▓░░░▓░░░░░▓░░░▓░▓░░░▓
▓░▓░▓▓▓▓▓░▓░▓▓▓░▓▓▓░▓▓▓▓▓░▓░▓▓▓▓▓░▓░▓▓▓░▓
▓░▓░▓★░░░░▓░▓░░░▓░░░▓░░░▓░▓░░░░░░░▓░░░░░▓
▓░▓░▓▓▓▓▓▓▓░▓▓▓▓▓░▓░▓▓▓░▓░▓▓▓▓▓▓▓▓▓▓▓▓▓░▓
▓░▓░░░░░░░░░▓░░░░░▓░░░░░▓░░░▓░░░▓░░░░░▓░▓
▓░▓▓▓▓▓▓▓▓▓░▓░▓▓▓▓▓░▓▓▓▓▓▓▓░▓░▓░▓░▓░▓▓▓░▓
▓░░░░░▓░░░░░▓░▓░░░░░▓░░░░░▓░▓░▓░░░▓░░░░░▓
▓░▓▓▓▓▓░▓▓▓▓▓░▓▓▓▓▓▓▓░▓▓▓░▓░▓░▓▓▓▓▓▓▓▓▓▓
▓░░░░░░░░░░░▓░░░░░░░░░░░▓░░░▓░░░░░░░░░░░▓
 ▓▓▓▓▓▓▓▓▓▓▓ ▓▓▓▓▓▓▓▓▓▓▓ ▓▓▓ ▓▓▓▓▓▓▓▓▓▓▓
